的	白勺
了	乛亅
我	丿丶
是	日一
在	f土
你	亻尔
和	禾口
有	f月
不	一丶
就	京尤
也	乛乚
都	者阝
要	覀女
吧	口巴
好	女子
他	亻也
说	讠兑
去	土厶
到	至刂
没	氵殳
上	丨一
还	辶不
对	又寸
那	刀阝
人	丿乀
个	人丨
看	手目
中	口丨
呢	口尼
来	一米
吗	口马
为	力丶
会	人云
她	女也
与	一一
给	纟合
等	⺮寺
这	辶文
用	冂丨
把	扌巴
下	丅丶
恩	因心
能	厶匕
很	彳艮
做	亻故
多	夕夕
想	心相
被	衤皮
点	占灬
而	丆冂
后	p口
一	一
又	乛乀
从	人人
再	一冉
将	丬夕
时	日寸
但	亻旦
过	辶寸
么	丿厶
打	扌丁
大	一人
年	r丨
啦	口扌
地	土也
以	𠄌人
买	乛头
里	田土
让	讠上
小	亅八
着	羊目
先	牛儿
啊	口阿
或	戈一
呀	口牙
并	丷开
找	扌戈
新	亲斤
及	乃乀
得	彳日
跟	足艮
于	一丁
太	大丶
嘛	口麻
号	口丂
日	口一
才	丁丿
发	f又
可	丁口
比	匕匕
玩	王元
最	日取
们	亻门
月	冂二
吃	口乞
真	直八
它	宀匕
其	h八
话	讠舌
请	讠青
钱	钅戋
叫	口丩
出	山山
开	一廾
哈	口合
当	v彐
家	宀豕
向	m口
问	门口
之	丶乛
更	一乂
该	讠亥
走	土人
别	另刂
快	忄夬
前	丷月
由	日丨
高	亠冂
您	心你
加	力口
天	一大
所	a斤
却	去卩
已	乛乚
谁	讠隹
写	冖与
内	冂人
啥	口舍
搞	扌高
老	耂匕
事	一亅
只	口八
拿	合手
带	艹巾
如	女口
死	一夕
行	彳亍
卖	十头
晕	日车
像	亻象
使	亻吏
刚	冈刂
成	戊𠃌
换	扌n
无	一人
嗯	口口
哪	口那
回	口口
爱	爫友
听	口斤
少	小丿
元	一儿
卡	上下
靠	告非
帮	巾邦
算	⺮廾
者	耂日
忙	忄亠
起	走乛
各	夂口
分	八刀
学	w子
总	丷心
心	丶丶
子	了一
手	丿丁
儿	丿乚
门	丶冂
黑	口灬
且	目一
鱼	n一
力	𠃌丿
亲	立朩
厂	一丿
刀	𠃌丿
青	圭月
丁	一亅
巴	乛乚
贝	冂人
目	口二
虫	中丶
丰	三丨
戈	弋丿
旦	日一
巾	冂丨
匕	乚丿
豕	一乀
则	贝刂
水	亅乛
改	己攵
唉	口矣
张	弓长
三	一一
连	辶车
见	冂人
放	方攵
王	一土
牛	r十
方	亠𠃌
马	乛一
雨	雨丶
木	十八
土	十一
骨	日月
弓	乛s
车	一十
万	丆𠃌
全	人王
按	扌安
区	匚乂
早	日十
拉	扌亠
偶	亻田
本	木一
页	丆贝
进	辶井
性	忄生
弄	王廾
第	⺮丨
完	宀元
同	冂口
系	丿糸
花	艹化
怕	忄白
女	乂一
讲	讠井
杀	乂朩
组	纟且
干	一十
错	钅昔
井	一廾
昔	h日
些	二此
此	止匕
止	丨一
住	亻主
跑	足包
名	夕口
夕	n丶
次	冫欠
睡	目千
网	冂乂
千	丿十
欠	n人
装	衣丬
衣	亠𧘇
挺	扌廷
掉	扌卓
图	口冬
正	丅一
外	夕卜
路	足各
二	一一
生	r土
应	广一
广	丶厂
冬	夂丶
卓	上十
卜	丨丶
头	丶人
因	口大
强	弓虽
作	亻乍
类	米大
送	辶关
每	r母
书	乛丶
乖	千北
法	氵去
拍	扌白
表	土𧘇
市	亠巾
撒	扌h
至	q土
接	扌亠
美	丷人
未	一木
办	力八
非	一一
哎	口艹
级	纟及
即	艮卩
米	丷木
关	丷天
乍	r丨
艮	日乀
版	片反
副	一刂
差	丷工
俺	人大
收	丩攵
男	田力
反	p又
工	丅一
字	宀子
股	月殳
几	丿乁
考	耂s
两	一冂
转	车专
块	土人
线	纟戋
周	冂吉
道	辶首
黄	h八
便	亻更
聊	耳c
猪	犭者
八	丿乀
耳	一丨
取	耳又
哇	口圭
低	亻氏
氏	丿乚
难	又隹
哦	口我
阿	阝可
受	爫又
包	勹巳
喝	口日
白	a日
金	人王
近	辶斤
斤	p丅
管	⺮官
四	口儿
定	宀𤴓
够	句多
交	亠父
样	木羊
李	木子
笑	⺮夭
传	亻专
自	a目
句	勹口
专	二s
夭	丿大
慢	忄日
边	辶力
刷	尸刂
户	丶尸
尸	口丿
型	土开
穿	穴牙
牙	一才
荣	艹木
著	艹者
遍	辶扁
影	日彡
越	走戊
戊	厂丶
位	亻立
贵	丨贝
长	丿乀
部	立阝
亏	一丂
存	丆子
师	丨帀
立	亠䒑
据	扌尸
怪	忄又
处	夂卜
选	辶先
站	立占
山	丨凵
另	口力
主	丶王
入	丿乀
占	上口
片	丿乛
店	广占
安	宀女
若	艹右
文	亠乂
式	戈工
国	口玉
血	a皿
共	h八
龙	f丶
气	r乁
鸟	a一
甘	一一
口	丨一
云	二厶
久	n乀
六	亠八
平	一十
罗	罒夕
令	人乛
左	f工
色	n巴
火	丶丶
南	十冂
吴	口天
局	尸口
华	十化
鬼	白厶
乐	c小
北	丬匕
肉	冂人
七	一乚
合	人口
石	丆口
易	日勿
十	一丨
军	冖车
身	a丿
库	广车
商	亠冂
玉	王丶
章	立早
宝	宀玉
亦	亠八
业	h一
丫	丶丨
含	今口
九	乁丿
直	十且
君	尹口
皮	乛又
吾	五口
民	口乚
布	f巾
尽	尺丶
凡	几丶
官	宀b
余	人小
古	十口
兰	丷三
今	人乛
齐	文h
亚	一一
友	f又
尚	尚口
羊	丷丨
宁	宀丁
乃	j丿
甲	田丨
史	口乂
右	f口
足	口上
支	十又
曲	日丨
丑	乛土
寸	丁丶
奇	大可
居	尸古
充	𠫓儿
川	丿丨
曹	h日
良	丶艮
夫	一大
永	丶水
录	彐水
母	l丶
肖	v月
争	n亅
斗	丶十
告	牛口
尼	尸匕
农	冖𧘇
曰	口一
吕	口口
申	日丨
庆	广大
仓	人㔾
倒	亻到
省	少目
谈	讠炎
称	禾尔
尔	n小
禾	丿木
台	厶口
群	君羊
汗	氵干
累	田糸
经	纟乛
查	木旦
象	n乀
变	亠又
半	丷丨
数	米攵
格	木各
面	丆口
红	纟工
陈	阝东
五	丅一
顶	丁页
楼	木米
读	讠十
某	甘木
乱	舌乚
条	夂朩
远	辶元
海	氵每
单	丷十
相	木目
东	一小
舌	千口
光	v儿
热	灬扌
咋	口乍
种	禾中
挂	扌圭
风	几乂
林	木木
额	客页
满	氵h
化	亻匕
班	王丨
滴	氵亠
涨	氵弓
机	木几
坐	十人
俄	亻我
飞	乁丶
度	广又
约	纟勺
勺	勹丶
刘	亠刂
歌	哥欠
报	扌𠬝
信	亻言
原	厂泉
饭	饣反
晚	日免
免	n人
夹	二人
士	十一
巨	匚口
空	穴工
毛	丿乚
西	一四
哥	可可
建	廴聿
曾	丷日
敢	乛攵
克	十儿
求	丁丶
电	日乚
重	千土
升	丿廾
朱	r木
春	𡗗日
节	艹卩
公	八厶
秀	禾乃
命	人口
田	口十
百	一白
果	田木
夏	百夂
竟	立儿
虽	口虫
员	口贝
乡	纟丿
步	止少
必	心丿
灵	彐火
志	士心
丽	一冂
世	廿l
州	丶川
武	戈止
庄	广土
灭	一火
登	癶一
瓦	一丶
司	𠃌口
觉	w见
蛋	乛虫
兄	口儿
谷	八口
产	亠厂
宗	宀示
吉	士口
圣	又土
末	一木
义	乂丶
宇	宀于
宜	宀且
丹	冂丶
严	一厂
币	丿巾
京	亠小
术	木丶
采	爫木
乜	乛乚 
劲	乛力
孟	子皿
甚	其l
卢	上尸
卫	乛一
吊	口巾
寺	土寸
乔	夭h
质	p贝
临	丨r
失	r大
父	八乂
扁	户𠃌
苗	艹田
乙	一乚
瓜	p乀
玄	亠幺
兆	儿八
犬	大丶
己	乛乚
兔	免丶
乌	a一
串	口丨
臣	匚口
鼠	臼乚
韦	一丨
尤	尢丶
乎	丿丁
互	一一
眉	尸目
勿	勹丿
弟	丷丿
叔	上又
赤	土h
介	人h
击	土山
寿	丰寸
朵	几木
丸	九丶
参	厶彡
穴	宀八
券	丷刀
鹿	广匕
舟	m一
爪	𠂆乀
尾	尸毛
叉	又丶
辰	厂𧘇
卵	c卪
午	r十
历	厂力
垂	千土
廷	廴壬
尺	尸乀
束	木口
丘	a一
丙	一人
屯	一乚
习	𠃌冫
弗	弓儿
召	刀口
奏	𡗗天
示	二小
贞	上贝
甫	十丶
责	圭贝
刃	刀丶
革	廿十
幺	纟丶
禹	丿冂
危	厃㔾
允	厶儿
卑	白十
冉	冂土
央	口人
夷	一人
贯	田贝
览	见h
矛	予丿
冈	冂乂
刁	𠃌丿
廿	一一
旬	勹日
乏	丿之
斥	斤乀
丈	一乂
吏	一史
圭	土土
肃	肀八
矢	r大
阜	a十
巳	乛乚
罕	冖干
乞	r乙
仑	人匕
卉	十廾
卯	c卩
弋	一丶
兀	一儿
亢	亠几
丕	不一
酉	西一
丐	一s
隶	肀氺
孑	了一
曳	日丿
戌	戊一
柬	十八
甬	乛用
戍	戊丶
聿	肀二
歹	一夕
戋	戈丶
亍	一丁
皿	皿一
臼	a一
亘	一一
韭	非一
匈	勹凶
刍	n彐
禺	田冂
匆	勿乀
缶	午凵
孛	土子
夂	n乀
殳	几又
隹	亻主
囟	m乂
量	旦里
村	木寸
伐	亻戈
间	门日
贴	贝占
盘	舟皿
爽	人乂
赚	贝兼
兼	丷h
往	彳主
队	阝人
杨	木j
狗	犭句
坏	土不
费	弗贝
岁	山夕
离	亠冂
明	日月
妈	女马
超	走召
均	土匀
切	七刀
期	其月
照	灬日
达	辶大
留	田匚
特	牜寺
动	云力
神	礻申
教	孝攵
梦	夕木
蛮	亠虫
唔	口五
值	亻直
骂	马口
陪	阝立
既	艮旡
哭	犬口
镇	钅真
洗	氵先
懂	忄艹
双	又又
指	扌匕
匀	勹冫
跌	足失
仍	亻乃
球	王求
活	氵千
练	纟东
清	氵青
提	扌日
亿	亻乙
除	阝余
通	辶甬
酒	氵酉
冲	冫中
饿	饣我
猫	犭苗
咩	口羊
票	覀示
假	亻卩
病	疒丙
画	一凵
抓	扌爪
呗	口贝
段	a殳
急	刍心
套	大厶
课	讠果
药	艹约
草	艹早
任	亻壬
理	王里
城	土成
货	贝化
唱	口日
哟	口纟
蓝	艹皿
抢	扌仓
常	v吊
菜	艹采
县	且厶
壬	丿土
混	氵日
集	木隹
感	咸心
咸	戊口
操	扌木
较	车交
退	辶艮
房	户方
脸	月人
破	石皮
件	亻牛
噢	口奥
呃	口厄
德	彳十
借	亻昔
声	士尸
傻	亻囱
囱	向夂
奥	向大
雪	雨彐
整	正束
喊	口咸
跳	足兆
补	衤卜
养	丷h
恶	亚心
现	王见
见	冂人
团	口才
砸	石匚
待	彳寺
篇	⺮扁
烦	火页
投	扌殳
根	木艮
深	氵冖
配	酉己
沈	氵冖
修	亻丨
款	士欠
知	矢口
叶	口十
何	亻可
器	口口
试	讠式
谢	讠射
层	尸云
仅	亻又
份	亻分
情	忄青
赵	走乂
需	雨而
记	讠己
流	氵亠
列	歹刂
招	扌召
论	讠仑
噶	口艹
痛	疒甬
率	亠十
香	禾日
封	圭寸
眼	目艮
冷	冫令
付	亻寸
派	氵p
帅	丨巾
阳	阝日
胡	古月
排	扌非
油	氵由
树	木又
停	亻亭
牌	片卑
科	禾斗
翻	采习
星	日生
随	阝辶
帖	巾占
权	木又
泡	氵包
价	亻介
追	辶a
场	土j
须	彡页
物	牜勿
背	月北
丢	丿厶
脚	月去
体	亻本
伤	亻r
羽	习习
解	角刀
剑	人刂
咱	口自
代	亻弋
底	广氐
氐	氏丶
角	n用
孙	子小
室	宀至
旧	丨日
极	木及
波	氵皮
铁	钅失
词	讠司
笨	⺮本
推	扌隹
证	讠正
炒	火少
耍	而女
输	车人
骗	马扁
轻	车乛
江	氵工
秒	禾少
落	艹洛
徐	彳余
短	矢豆
夜	亠亻
吹	口欠
游	氵方
姐	女且
板	木反
咁	口甘
赢	亡月
许	讠午
苦	艹古
烂	火兰
博	十尃
素	圭糸
利	禾刂
诗	讠寺
烧	火尧
尧	戈兀
豆	一一
睇	目弟
静	青争
制	牛刂
欲	谷欠
汤	氵j
冰	冫水
造	辶告
断	l斤
忘	亡心
亡	亠l
茶	艹朩
呆	口木
抽	扌由
案	宀木
供	亻共
抱	扌包
烟	火因
初	衤刀
野	里予
予	乛亅
胖	月半
品	口口
紧	糸丨
绿	纟录
项	工页
故	古攵
签	⺮一
调	讠周
服	月𠬝
苏	艹办
奖	大丬
兵	丘八
演	氵寅
填	土真
英	艹央
嘴	口角
般	舟殳
挖	扌宀
准	冫隹
保	亻呆
硬	石更
寒	宀丶
挑	扌兆
莫	艹大
鸡	又鸟
唐	广口
寄	宀奇
闹	门市
言	亠口
防	阝方
纯	纟屯
距	足巨
题	是页
源	氵原
街	彳圭
座	广土
思	田心
删	冂刂
亮	亠几
穷	穴力
灯	火丁
郭	亠阝
戏	又戈
桥	木乔
党	尚兄
爆	火日
首	丷自
粉	米分
念	今心
钟	钅中
疼	疒冬
属	尸禹
戴	g田
然	灬夕
韩	十韦
扣	扌口
租	禾且
捏	扌日
港	氵巷
狼	犭良
雷	雨田
盖	羊皿
狂	犭王
引	弓丨
压	厂土
佛	亻弗
梁	木氵
猛	犭孟
船	舟几
托	扌乇
恨	忄艮
赛	宀贝
宋	宀木
乇	丿七
客	宀各
斯	其斤
沙	氵少
腿	月辶
领	令页
银	钅艮
码	石马
祝	礻兄
望	王亡
缺	缶夬
战	占戈
食	人艮
床	广木
抗	扌亢
贼	贝戎
界	田介
困	口木
河	氵可
郑	关阝
松	木公
否	不口
园	口元
折	扌斤
戎	戈十
福	礻一
遭	辶曹
猜	犭青
伊	亻尹
尹	彐丿
秋	禾火
端	立山
熊	灬厶
滚	氵衮
插	扌千
毒	圭母
获	艹犭
衮	亠𧘇
秦	𡗗禾
卷	丷㔾
持	扌寺
设	讠殳
架	木力
朝	十月
归	丨彐
喂	口畏
畏	田𧘇
踢	足易
搬	扌舟
迷	辶米
胜	月生
赶	走干
基	其土
意	立心
拖	扌r
摸	扌莫
惨	忄参
爸	父巴
订	讠丁
塔	土艹
纸	纟氏
散	h攵
姓	女生
呈	口王
洋	氵羊
圈	口卷
喜	吉口
咬	口交
嘎	口百
闪	门人
富	宀田
治	氵台
喔	口屋
汉	氵又
料	米斗
院	阝完
批	扌比
逛	辶犭
峰	山夂
醒	酉星
狠	犭艮
咧	口歹
爬	爪巴
屋	尸至
梅	木每
降	阝夅
瘦	疒又
结	纟吉
疯	疒风
偷	亻俞
语	讠五
枪	木仓
踩	足采
精	米青
呵	口可
软	车欠
杜	木土
赞	贝先
依	亻衣
展	尸𧘇
冇	f冂
康	广隶
救	求攵
兴	w八
倍	亻立
堂	v土
鞋	革圭
愿	厂心
键	钅建
似	亻以
冒	日目
音	立日
守	宀寸
观	又见
仲	亻中
弱	弓弓
替	日夫
係	亻系
笔	⺮毛
闲	门木
逼	辶一
舞	r夕
吓	口下
测	氵贝
状	丬犬
宽	宀见
箱	⺮木
程	禾呈
细	纟田
偏	亻扁
耶	耳阝
联	耳关
湖	氵古
晒	日西
柳	木卯
锁	钅v
印	c卩
味	口未
紫	糸止
众	人人
零	雨令
环	王不
实	宀头
答	⺮合
娘	女良
厚	厂子
懒	忄束
标	木示
孔	子乚
欧	区欠
闷	门心
吖	口丫
勒	革力
岛	鸟山
顾	厄页
运	辶云
抛	扌九
顺	川页
陆	阝击
雅	牙隹
厄	厂㔾
厅	厂丁
温	氵日
轮	车仑
微	彳山
社	礻土
杰	木灬
奶	女乃
杯	木不
搜	扌叟
凭	几任
洞	氵同
魔	广鬼
编	纟扁
叟	臼又
虎	虍几
囧	口八
佳	亻圭
佢	亻巨
酸	西厶
形	开彡
墙	土啬
圆	口员
害	宀口
档	木当
负	n贝
喽	口娄
娄	米女
范	艹氵
糖	米唐
煮	者灬
拟	扌以
致	至攵
屁	尸比
稳	禾急
景	日京
吐	口土
碰	石並
注	氵主
肥	月巴
挣	扌争
晓	日尧
侯	亻乛
盛	成皿
脱	月兑
擦	扌察
仙	亻山
暗	日音
砍	石欠
熟	灬享
麻	广木
舍	人舌
勾	勹厶
罢	罒去
享	亠子
察	宀祭
亨	亠了
构	木勾
兑	丷兄
亥	亠人
皆	白比
琴	今王
创	仓刂
宫	宀吕
继	纟l
宏	宀厷
施	方r
善	羊口
增	土曾
例	亻列
税	禾兑
嫩	女束
肯	止月
押	扌甲
视	礻见
横	木黄
怒	心奴
扔	扌乃
忍	刃心
腰	月要
祭	示夕
臭	自犬
艾	艹乂
泪	氵目
净	冫争
敏	每攵
吵	口少
罪	罒非
伟	亻韦
响	口向
棒	木奉
邓	又阝
减	冫咸
拆	扌斥
蔡	艹祭
奉	𡗗丨
祭	示夕
闻	门耳
杂	九朩
麦	圭夂
冯	冫马
妹	女未
塞	宀土
董	艹重
潘	氵番
醉	酉卒
耐	而寸
旁	亠方
丝	一纟
计	讠十
校	木交
姜	羊女
抄	扌少
蒋	艹将
核	木亥
维	纟隹
灰	f火
番	采田
卒	亠十
钢	钅冈
催	亻崔
楚	乛林
认	讠人
乘	千北
俊	亻夋
返	辶反
芳	艹方
榜	木旁
矿	石广
仁	亻二
瑞	王山
评	讠平
添	氵天
酷	酉告
绝	纟色
飘	票风
威	戊女
刻	亥刂
摆	扌罢
崔	山隹
炸	火乍
嘿	口黑
犯	犭㔾
鲁	鱼日
铜	钅同
具	且八
挤	扌齐
届	尸由
瓶	并瓦
密	宀山
黎	氺禾
馆	饣官
射	身寸
索	十糸
显	日业
季	禾子
拼	扌并
族	方r
寻	彐寸
洪	氵共
骑	马奇
容	宀谷
辉	光军
智	日知
复	r夂
普	並日
剧	居刂
扯	扌止
竹	rr
燕	艹灬
脑	月亠
撞	扌童
礼	礻乚
聚	乑取
讯	讠卂
膜	月莫
诺	讠若
搭	扌艹
魏	委鬼
泽	氵又
胃	田月
侧	亻贝
彭	壴彡
委	禾女
钻	钅占
袁	土𧘇
凤	几又
窝	穴呙
凉	冫京
阴	阝月
蒙	艹豕
躲	身朵
赖	束负
堆	土隹
甜	舌甘
赴	走卜
盐	皿土
粗	米且
举	兴丨
载	g车
帐	巾长
露	雨路
训	讠川
驻	马主
瞎	目害
劝	又力
逃	辶兆
惹	若心
彩	采彡
休	亻木
独	犭虫
藏	艹臧
姚	女兆
浪	氵良
喇	口束
纳	纟内
针	钅十
嘉	吉加
吨	口屯
忠	中心
吸	口及
泰	𡗗氺
森	木木
萧	艹肃
功	工力
跨	足夸
夸	大亏
臧	戊臣
症	疒正
哼	口亨
灌	氵艹
缘	纟彖
蛇	虫它
喷	口贲
盒	合皿
导	巳寸
略	田各
拜	手一
扫	扌彐
购	贝勾
饮	饣欠
贱	贝戋
昏	氏日
虚	虍业
敲	高攴
岩	山石
巧	工丂
埋	土里
娜	女那
侬	亻农
弹	弓单
愁	心秋
凯	岂几
淡	氵炎
炎	火火
优	亻尤
池	氵也
什	亻十
汇	氵匚
萨	艹阝
屏	尸并
泥	氵尼
勇	甬力
怀	忄不
铺	钅甫
扬	扌j
迟	辶尺
磨	广石
怎	乍心
呼	口乎
赌	贝者
涂	氵余
财	贝才
栏	木兰
遇	辶禺
薛	艹a
泉	白水
呙	口内
汪	氵王
稍	禾肖
嫁	女家
锅	钅呙
终	纟冬
攻	工攵
扎	扌乚
娃	女圭
叼	口刁
隔	阝一
赔	贝立
祥	礻羊
呐	口内
液	氵夜
碗	石宛
绕	纟尧
佐	亻左
宛	宀夕
棕	木宗
旺	日王
漏	氵尸
凑	冫奏
贾	覀贝
雄	厷隹
湿	氵显
吻	口勿
框	木匡
探	扌冖
胸	月匈
凶	凵乂
匡	匚王
碟	石世
洛	氵各
健	亻建
速	辶束
辆	车两
顿	屯页
拔	扌发
唯	口隹
暴	日氺
沟	氵勾
仪	亻义
郎	良阝
尿	尸水
脏	月庄
希	乂布
逗	辶豆
识	讠只
珠	王朱
惠	十心
菲	艹非
透	辶秀
谭	讠覀
诶	讠矣
凌	冫夌
府	广付
播	扌番
嫌	女兼
妳	女尔
窗	穴囱
残	歹戋
砖	石专
阵	阝车
昌	日日
患	串心
废	广发
哩	口里
矣	厶失
捡	扌佥
帝	亠丨
剪	前力
稿	禾高
邦	丰阝
坑	土亢
陶	阝匋
营	艹口
剂	齐刂
熬	灬敖
舒	舍予
玲	王令
模	木莫
甩	月乚
贤	贝丨
趁	走㐱
拨	扌发
栋	木东
沿	氵几
盗	皿次
伴	亻半
尊	酋寸
敖	土攵
酋	丷酉
妖	女夭
锦	钅帛
琳	王林
幽	山幺
域	土或
浅	氵戋
袋	衣代
限	阝艮
浩	氵告
霜	雨相
豪	亠豕
置	罒直
俾	亻卑
祖	礻且
颜	彦页
肺	月市
惊	忄京
煤	火某
趟	走尚
辣	辛束
辛	立十
扇	户羽
彦	产彡
帛	白巾
涛	氵寿
附	阝付
遂	辶㒸
划	戈刂
恒	忄亘
欣	斤欠
墨	黑土
围	口韦
剩	乘刂
娶	女取
慧	心丰
备	夂田
鲜	鱼羊
撤	扌育
助	且力
撑	扌掌
沉	氵冗
诸	讠者
险	阝佥
震	雨辰
鹏	朋鸟
割	害刂
烤	火考
斌	文武
掌	尚手
控	扌空
暨	旦既
哒	口达
贺	贝加
锋	钅夆
童	立里
饰	饣r
挡	扌当
伯	亻白
馨	香声
冗	冖几
壳	士冗
诚	讠成
恋	亦心
浓	氵农
轩	车干
振	扌辰
虾	虫下
庭	广廷
晴	日青
靓	青见
坊	土方
魂	云鬼
晨	日辰
镜	钅竟
曼	日又
肝	月干
益	丷皿
禁	示木
征	彳正
爹	父多
粥	弓米
盾	p目 
尘	土八
消	氵肖
喃	口南
艳	丰色
纪	纟己
枫	木风
妞	女丑
昂	日c
暖	日爰
隆	阝夂
柱	木主
奔	大卉
败	贝攵
政	正攵
滑	氵骨
廖	广㐱
误	讠吴
妻	十女
刺	朿刂
沪	氵户
邱	丘阝
润	氵闰
闰	门王
莲	艹连
捞	扌劳
冠	冖元
婚	女昏
舔	舌天
湾	氵弯
躺	身尚
仔	亻子
桑	木又
鑫	金金
饱	饣包
链	钅连
促	亻足
敬	苟攵
迪	辶由
咪	口米
摄	扌聂
蒸	艹灬
愈	俞心
弯	亦弓
劳	艹力
聂	耳又
俞	人月
苟	艹句
阁	门各
承	了乛
摔	扌率
杆	木干
潮	氵朝
勤	堇力
碎	石卒
医	匚矢
葛	艹勹
邪	牙阝
吼	口孔
妙	女少
珍	王㐱
始	女台
俗	亻谷
迎	辶c
续	纟卖
抬	扌台
歪	不正
售	口隹
伦	亻仑
胶	月交
启	户口
捧	扌奉
研	石开
符	⺮付
晃	日光
苑	艹夕
爷	父卩
雾	雨务
亭	亠丁
刮	舌刂
哄	口共
嗲	口爹
兽	丷口
邹	刍阝
鸣	口鸟
嗨	口海
罚	罒讠
旗	方r
积	禾只
湘	氵相
铝	钅吕
斜	余斗
预	予页
欢	又欠
枝	木支
芬	艹分
溪	氵奚
务	夂力
奚	爫大
洲	氵州
鸭	甲鸟
捐	扌肙
炮	火包
岗	山冈
轴	车由
翔	羊羽
简	⺮间
堵	土者
携	扌隽
染	木氵
饼	饣并
萍	艹氵
隐	阝急
餐	食歺
戒	戈廾
逸	辶兔
贷	贝代
岳	丘山
荷	艹何
憋	心敝
薄	艹溥
仿	亻方
肾	月丨
朗	良月
异	巳廾
桂	木圭
敝	㡀攵
溥	氵尃
扑	扌卜
瞧	目焦
鸿	氵工
颗	果页
霞	雨尸
晶	日日
延	廴丿
箭	⺮前
鼓	壴支
棉	木帛
籍	⺮耒
桌	上木
玛	王马
艺	艹乙
坤	土申
私	禾厶
柔	矛木
倾	亻顷
检	木佥
腾	月丷
焦	灬隹
资	贝次
碧	石王
浴	氵谷
盆	分皿
亩	亠田
顷	匕页
烫	火汤
究	穴九
寅	宀八
鹤	隺鸟
琢	王豕
挥	扌军
护	扌户
毁	臼殳
皇	白王
粒	米立
汁	氵十
伞	人十
莱	艹来
洁	氵吉
哲	口折
涵	氵函
企	人止
岭	山令
咳	口亥
浜	氵兵
屎	尸米
衰	亠𧘇
盟	皿明
翼	異羽
函	凵乛
钙	钅丐
判	半刂
妮	女尼
傅	亻尃
驴	马户
铭	钅名
迈	辶万
柯	木可
宠	宀龙
桶	木甬
殿	尸殳
菌	艹口
淫	氵爫
敌	舌攵
旭	九日
航	舟亢
棋	木其
访	讠方
拽	扌曳
翠	卒羽
坡	土皮
鹰	广鸟
纹	纟文
孝	耂子
技	扌支
译	讠又
挨	扌矣
肩	户月
册	冂一
培	土立
融	一虫
移	禾多
韵	音匀
毕	十比
势	力执
执	扌丸
截	g隹
渡	氵度
薇	艹微
扶	扌夫
啃	口肯
摘	扌亠
怡	忄台
壮	丬士
宅	宀乇
盼	目分
耒	二木
耗	耒毛
妍	女开
摇	扌爫
抹	扌末
莉	艹利
孤	子瓜
榄	木览
橄	木敢
芯	艹心
讨	讠寸
桃	木兆
规	夫见
职	耳只
磊	石石
序	广予
宾	宀兵
腔	月空
悟	忄吾
典	曲八
樊	大木
议	讠义
辑	车口
聘	耳由
峻	山夋
镔	钅宾
逻	辶罗
乳	孚乚
锡	钅易
夺	大寸
确	石角
醋	酉昔
孚	爫子
统	纟充
悉	采心
迅	辶卂
扰	扌尤
宙	宀由
旅	方r
损	扌员
握	扌屋
拳	丷手
帕	巾白
颇	皮页
奴	女又
矮	矢委
龟	n乚
庙	广由
霍	雨隹
菊	艹勹
绑	纟邦
闯	门马
辞	舌辛
壁	土辟
枕	木冘
渐	氵斩
岸	山干
婆	女波
胆	月旦
虹	虫工
尝	v云
晋	亚日
凝	冫疑
疑	匕乛
辟	尸辛
澡	氵木
避	辶辟
弦	弓玄
撮	扌最
贪	今贝
抵	扌氐
息	自心
俱	亻具
噻	口塞
骚	马蚤
塘	土唐
漆	氵木
蝶	虫世
兮	八s
郝	赤阝
芝	艹之
蚤	叉虫
逢	辶夆
浮	氵孚
材	木才
捌	扌别
缝	纟逢
娟	女口
耀	光翟
萌	艹明
蹭	足曾
翟	隹羽
烈	灬列
痒	疒羊
伸	亻申
槽	木曹
翁	公羽
盈	乃皿
柜	木巨
审	宀申
渣	氵查
斑	王文
恐	心巩
殷	a殳
巩	工凡
悲	心非
裤	衤库
袜	衤末
炉	火户
溜	氵留
幻	幺𠃌
逆	辶屰
伪	亻为
柴	木此
固	口古
抖	扌斗
悦	忄兑
屈	尸出
脉	月永
衫	衤彡
忽	勿心
怨	心夕
粮	米良
冻	冫东
彬	林彡
献	南犬
熙	灬匚
摩	广手
胎	月台
婷	女亭
缩	纟宿
赏	尚贝
兹	丷幺
津	氵聿
递	辶弟
枚	木攵
卿	c艮
颖	匕页
济	氵齐
拷	扌考
漫	氵曼
谱	讠普
淘	冫匋
匋	勹缶
墓	莫土
候	亻丨
宿	宀佰
佰	亻百
幅	巾一
茂	艹戊
咯	口各
牵	大牛
雁	厂亻
娇	女乔
御	彳卸
窄	穴乍
郡	君阝
映	日央
掏	扌匋
琼	王京
缓	纟爰
弃	𠫓廾
唇	辰口
佩	亻几
汝	广女
昨	日乍
策	⺮朿
琪	王其
雯	雨文
肌	月几
坛	土云
邀	辶白
协	十办
猴	犭侯
销	钅肖
揉	扌柔
漂	氵票
攒	扌赞
肠	月乛
债	亻责
坚	土丨
倪	亻臼
藤	匚滕
慌	忄荒
蒂	艹帝
诉	讠斥
蟹	虫解
态	太心
梨	木利
幸	土十
炼	火东
忧	忄尤
鼻	白廾
育	亠月
酱	酉丬
堡	土保
荒	艹川
滕	月丷
叹	口又
拐	扌另
陷	阝n
鹅	我鸟
蜜	宀虫
腹	月复
葱	艹心
粤	m丂
席	广巾
苍	艹仓
捉	扌足
孩	子亥
赫	赤赤
肿	月中
效	交攵
澳	冫奥
钓	钅勺
帧	巾贞
侠	亻夹
儒	亻需
决	冫夬
闭	门才
扭	扌丑
癌	疒山
泵	石水
捷	扌疌
妆	丬女
彼	彳皮
适	辶舌
泛	氵乏
瘤	疒留
龚	龙共
盯	目丁
纵	纟从
默	黑犬
忌	己心
炖	火屯
逾	辶俞
绣	纟秀
悬	县心
宰	宀辛
埃	土矣
罐	缶艹
奈	大示
洒	氵西
叻	口力
伏	亻犬
鼎	目s
幼	幺力
莹	艹玉
旋	方r
刑	开刂
囊	十𧘇
担	扌旦
粘	米占
触	角虫
踏	足沓
牢	宀牛
帽	巾冒
妃	女己
煎	前灬
频	步页
昭	日召
拥	扌用
巷	共巳
犹	犭尤
弘	弓厶
扛	扌工
揭	扌日
裸	衤果
柏	木白
账	贝长
霸	雨革
啵	口波
僧	亻曾
摊	扌难
掐	扌n
突	穴犬
蓉	艹容
蕾	艹雷
扛	扌工
揭	扌日
裸	衤果
柏	木白
账	贝长
霸	雨革
啵	口波
僧	亻曾
摊	扌难
掐	扌n
突	穴犬
蓉	艹容
蕾	艹雷
彪	虎彡
揍	扌奏
壹	士豆
毅	亠殳
罩	罒卓
拒	扌巨
淋	氵林
赠	贝曾
警	言敬
逐	辶豕
痕	疒艮
歇	日欠
迁	辶千
钩	钅勾
扮	扌分
祸	礻呙
淑	氵叔
逐	辶豕
痕	疒艮
歇	日欠
迁	辶千
钩	钅勾
扮	扌分
祸	礻呙
淑	氵叔
裂	衣列
渝	氵俞
颈	乛页
昆	日比
涅	氵日
喻	口俞
忆	忄乙
嘞	口勒
朕	月关
惯	忄田
氧	气羊
仕	亻士
境	土竟
棍	木昆
律	彳聿
恰	忄合
斋	文而
惜	忄昔
坪	土平
姆	女母
浦	氵甫
稀	禾希
拓	扌石
裙	衤君
吞	天口
虐	虍彐
芸	艹云
疏	𤴔㐬
叠	且又
劫	去力
颠	真页
郁	有阝
锌	钅辛
砂	石少
沾	氵占
邮	由阝
翘	尧羽
穗	禾惠
涌	氵甬
株	木朱
潜	氵替
聪	耳总
陵	阝夌
糊	米胡
谓	讠胃
壶	士业
媚	女眉
饶	饣尧
庚	广人
慕	艹小
坦	土旦
咖	口加
寨	宀朩
繁	糸敏
搓	扌差
蚊	虫文
监	皿丨
霖	雨林
绍	纟召
遥	辶䍃
牧	牜攵
验	马佥
楠	木南
吟	口今
裴	非衣
缠	纟广
哉	g口
郁	有阝
锌	钅辛
砂	石少
沾	氵占
邮	由阝
翘	尧羽
穗	禾惠
涌	氵甬
株	木朱
潜	氵替
聪	耳总
陵	阝夌
糊	米胡
谓	讠胃
壶	士业
媚	女眉
饶	饣尧
庚	广人
慕	艹小
坦	土旦
咖	口加
寨	宀朩
繁	糸敏
搓	扌差
蚊	虫文
监	皿丨
霖	雨林
绍	纟召
遥	辶䍃
牧	牜攵
验	马佥
楠	木南
吟	口今
裴	非衣
缠	纟广
哉	g口
齿	止凵
浇	氵尧
朋	月月
庞	广龙
惟	忄隹
拾	扌合
膏	高月
坝	土贝
锐	钅兑
筒	⺮同
敷	甫攵
喵	口苗
涉	氵步
粪	米共
挪	扌那
署	罒者
拧	扌宁
阮	阝元
佬	亻老
储	亻诸
碳	石炭
荡	艹汤
炭	山灰
桩	木庄
趴	足八
蹲	足尊
遮	辶庶
戳	翟戈
纱	纟少
崇	山宗
钦	钅欠
瑶	王䍃
赋	贝武
奎	大圭
渠	木氵
仇	亻九
盲	亡目
坎	土欠
蹦	足崩
崩	山朋
庶	广灬
扩	扌广
跃	足夭
杭	木亢
钉	钅丁
趣	走取
臂	月辟
泼	氵发
幕	莫巾
邢	开阝
筹	⺮寿
棚	木朋
焊	火旱
禅	礻单
岚	山风
拌	扌半
疾	疒矢
裕	衤谷
滨	氵宾
筋	⺮肋
栽	g木
趋	走刍
蠢	春虫
卦	圭卜
旱	日干
肋	月力
砷	石申
镓	钅家
臭	自犬
宣	宀亘
姬	女匚
尖	八大
伍	亻五
邵	召阝
酶	酉每
谋	讠某
穆	禾白
垫	土执
暂	日斩
腻	月贰
贰	弋贝
斩	车斤
兜	c白
苯	艹本
卧	臣卜
阻	阝且
咒	几口
琦	王奇
绳	纟黾
耿	耳火
贫	分贝
阅	门兑
铃	钅令
撕	扌斯
艘	舟叟
浆	水丬
竞	立兄
靖	立青
搅	扌觉
珊	王册
笼	⺮龙
倚	亻奇
痰	疒炎
舰	舟见
缸	缶工
妇	女彐
帆	巾凡
炫	火玄
狐	犭瓜
徒	彳走
植	木直
姻	女因
释	采又
拣	扌东
赐	贝易
脂	月旨
秘	禾必
佑	亻右
鲍	鱼包
沃	氵夭
袖	衤由
述	辶术
姨	女夷
啸	口肃
硅	石圭
杖	木丈
旨	匕日
焉	正s
捅	扌甬
芽	艹牙
倩	亻青
筑	⺮巩
姿	女次
傲	亻敖
径	彳乛
邻	令阝
激	氵白
咦	口夷
雕	周隹
铅	钅几
姑	女古
桐	木同
捂	扌吾
踹	足山
辩	辛讠
舱	舟仓
幢	巾童
覆	覀彳
潭	氵覃
覃	覀早
钠	钅内
拦	扌兰
恤	忄血
煲	火保
糟	米曹
轰	车又
阎	门n
脆	月危
燃	火然
凸	丨s
凹	丨s
龄	齿令
锤	钅垂
窜	穴串
鞍	革安
痴	疒知
孕	乃子
瑟	必王
茹	艹如
搁	扌阁
缴	纟白
驱	马区
熏	千黑
滩	氵难
搂	扌娄
织	纟只
磷	石米
浸	氵彐
咏	口永
阶	阝介
衡	彳n
驾	马加
哀	亠𧘇
昊	日天
辅	车甫
鄂	咢阝
谦	讠兼
窑	穴缶
蒲	艹浦
晖	日军
屌	尸吊
硕	石页
泻	氵写
屡	尸娄
涩	氵刃
择	扌又
灾	宀火
碑	石卑
丛	一人
柄	木丙
樱	木婴
揽	扌览
奸	女干
俩	亻两
竖	立丨
措	扌昔
眠	目民
婉	女宛
薰	艹熏
婴	女贝
麟	鹿米
磁	石兹
坠	土队
揪	扌秋
禄	礻录
侃	亻口
娅	女亚
咽	口因
仗	亻丈
瑜	王俞
畅	申j
碱	石咸
逝	辶折
肚	月土
阀	门伐
攀	手木
皱	刍皮
宴	宀女
瘾	疒隐
跪	足危
唤	口奂
奂	n央
途	辶余
鞭	革便
狄	犭火
勋	员力
辽	辶了
瓷	瓦次
帘	穴巾
谜	讠迷
厉	厂万
磅	石旁
闸	门甲
瞄	目苗
裁	g衣
娥	女我
宪	宀先
扒	扌八
沁	氵心
崖	山厓
刊	干刂
迹	辶亦
霉	雨每
乾	𠦝乞
氮	气炎
傍	亻旁
葬	艹廾
钧	钅匀
喘	口耑
詹	厃言
骆	马各
闫	门三
楞	木罒
授	扌受
辨	辛丨
嚼	口爵
拎	扌令
虞	虍吴
爵	爫艮
遗	辶贵
披	扌皮
阔	门活
媛	女爰
坟	土文
剥	录刂
岂	山己
悠	心攸
塌	土日
卸	𦈢卩
愚	禺心
攸	亻丨
喉	口候
窦	穴卖
狮	犭师
藕	艹耦
垮	土夸
怜	忄令
拱	扌共
慈	兹心
脾	月卑
氢	气乛
溶	氵容
巢	巛果
抚	扌无
焕	火奂
廉	广兼
燥	火木
泄	氵世
钾	钅甲
橙	木登
颂	公页
铲	钅产
栓	木全
睿	上目
堤	土是
枯	木古
暮	莫日
堪	土甚
冤	冖兔
篮	⺮监
抠	扌区
酥	酉禾
巫	工人
雀	少隹
裹	亠𧘇
劈	刀辟
骏	马夋
畔	田半
灿	火山
芒	艹亡
灶	火土
杏	木口
腐	府肉
冥	冖六
绘	纟会
筱	⺮攸
蜀	罒勹
渔	氵鱼
醇	酉享
袭	龙衣
薪	艹新
婕	女疌
梳	木㐬
黛	黑代
孰	享丸
瞪	目登
铸	钅寿
茨	艹次
轨	车九
拂	扌弗
搏	扌尃
驰	马也
豹	豸勺
蜡	虫昔
渊	氵丿
荤	艹军
蒜	艹示
皓	白告
戚	戊尗
际	阝示
弊	廾敝
嫂	女叟
馅	饣n
茅	艹矛
叁	厶三
枣	朿丶
曦	日羲
棵	木果
澄	氵登
羲	羊丿
飙	犬风
鉴	金丨
嗦	口索
誓	言折
塑	土朔
耕	耒井
炳	火丙
朴	木卜
敦	享攵
瞳	目童
羞	羊丑
稻	禾舀
彤	丹彡
笛	⺮由
媒	女某
恭	共小
冀	異北
匹	匚儿
祁	礻阝
蜂	虫夆
眺	目兆
渴	氵日
妾	立女
沐	氵木
估	亻古
仰	亻c
忒	弋心
滥	氵监
嘘	口虚
辈	车非
弥	弓尔
朔	屰月
舀	爫臼
糸	幺小
钛	钅太
丧	十𧘇
捕	扌甫
磕	石去
陀	卩它
煞	灬刍
沧	氵仓
努	力奴
茎	艹乛
呸	口丕
汽	氵气
炜	火韦
溅	氵贱
蕊	艹心
梗	木更
闵	门文
捣	扌岛
屠	尸者
氨	气安
玮	王韦
翅	支羽
氯	气录
叙	余又
惑	或心
奕	亦大
氟	气弗
呦	口幼
豫	予象
荆	艹刂
撇	扌敝
络	纟各
胀	月长
详	讠羊
瓣	辛瓜
迥	辶冂
淮	氵隹
蓬	艹逢
况	冫兄
浙	氵折
掘	扌屈
溢	氵益
挫	扌坐
梓	木辛
巡	辶巛
慎	忄真
绮	纟奇
逮	辶隶
徽	彳山
瞒	目艹
谨	讠廿
葵	艹癸
寇	宀元
舜	爫夕
绵	纟帛
匪	匚非
佟	亻冬
昕	日斤
苔	艹台
翰	𠦝人
荐	艹存
蹬	足登
墩	土敦
晾	日京
貌	豸白
茜	艹西
耻	耳止
觅	爫见
硫	石㐬
闽	门虫
纲	纟冈
诱	讠秀
侵	亻彐
哑	口亚
抑	扌c
掰	手分
削	肖刂
寝	宀丬
蔚	艹尉
迦	辶加
颤	亶页
掂	扌店
淤	氵方
痣	疒志
捆	扌困
腕	月宛
贡	工贝
猎	犭昔
澜	氵阑
阑	门柬
尉	尸寸
污	氵亏
援	扌爰
掀	扌欣
泳	氵永
逊	辶孙
萱	艹宣
臀	月殿
俏	亻肖
愣	忄罒
娱	女吴
矫	矢乔
悔	忄每
挠	扌尧
玫	王攵
蓄	艹畜
镁	钅美
绊	纟半
瑛	王英
循	彳盾
侍	亻寺
概	木既
馋	饣免
绪	纟者
妥	爫女
甄	西瓦
汀	氵丁
颐	匚页
唆	口夋
掩	扌奄
畜	玄田
奄	大电
垒	土厶
呕	口区
酮	酉同
钰	钅玉
菁	艹青
胤	丿幺
蛙	虫圭
璇	王旋
畴	田寿
茗	艹名
芙	艹夫
蘸	艹酉
窍	穴巧
梯	木弟
雇	户隹
茵	艹因
瞅	目秋
庵	广奄
勃	孛力
糕	米羔
诀	讠夬
夬	乛人
羔	羊灬
锭	钅定
沥	氵历
欺	其欠
菱	艹夌
碘	石典
莎	艹沙
雌	此隹
膝	月木
侨	亻乔
籽	米子
峡	山夹
酿	酉良
眨	目乏
泊	氵白
隋	阝左
绒	纟戎
臻	至秦
衬	衤寸
胺	月安
秉	千八
僵	亻一
杉	木彡
祛	礻去
纽	纟丑
伽	亻加
迫	辶白
掺	扌参
斐	文非
岑	山今
玖	王久
遣	辶虫
陡	阝走
贩	贝反
夌	土夂
溟	氵冥
萝	艹罗
滞	氵带
镶	钅襄
蕴	艹纟
仨	亻三
嫖	女票
冶	冫台
嗜	口老
厌	厂犬
肆	镸聿
淳	氵享
嗒	口艹
璐	王路
叽	口几
黔	黑今
摁	扌恩
禽	人冂
彻	彳切
魁	鬼斗
嵌	山甘
疗	疒了
椅	木奇
廊	广郎
袍	衤包
滋	氵兹
焰	火n
挽	扌免
稠	禾周
睁	目争
髓	骨辶
栗	覀木
呛	口仓
札	木乚
呜	口乌
螺	虫累
渗	氵参
纬	纟韦
魅	鬼未
笋	⺮尹
涯	氵厓
晏	日安
靳	革斤
桓	木亘
诊	讠㐱
描	扌苗
瑾	王廿
藻	艹澡
蚕	天虫
捻	扌念
沽	氵古
刨	包刂
沫	氵末
镍	钅自
寂	宀叔
襄	亠𧘇
慰	心尉
芦	艹户
叮	口丁
厨	厂豆
芷	艹止
寡	宀刀
踪	足宗
荫	艹阴
祠	衤司
矩	矢巨
嗅	口臭
雍	亠乡
嫣	女焉
募	莫力
榕	木容
裔	衣冂
袄	衤夭
秤	禾平
杠	木工
肏	入肉
钮	钅丑
役	彳殳
烙	火各
贸	贝c
窥	穴规
契	大丰
疆	弓一
裘	求衣
眸	目牟
簿	⺮溥
淹	氵奄
贬	贝乏
浊	氵虫
盏	戋皿
拴	扌全
棠	v呆
劣	少力
屄	尸穴
芹	艹斤
沛	氵巿
泣	氵立
殊	歹朱
箫	⺮肃
琛	王罙
椰	木耶
驶	马史
瞬	目舜
履	尸彳
崽	山思
蚀	饣虫
噪	口木
誉	兴言
皖	白完
析	木斤
婧	女青
庸	广肀
倦	亻卷
芭	艹巴
陕	阝夹
撩	扌尞
熔	火容
湛	氵甚
祈	礻斤
恼	忄亠
邑	口巴
腺	月泉
肤	月夫
掷	扌郑
毫	亠毛
厢	厂相
洽	氵合
烨	火华
靴	革化
珂	王可
滇	氵真
铬	钅各
衍	彳氵
衔	彳钅
督	目叔
浑	氵军
嬲	男女
奋	大田
艇	舟廷
痘	疒豆
瞥	目敝
簇	⺮族
酚	酉分
砌	石切
蝉	虫单
腌	月奄
梵	凡林
苇	艹韦
晟	日成
膊	月尃
茬	艹在
祺	礻其
堕	土阝
桦	木华
涮	氵刷
胞	月包
筛	⺮师
霄	雨肖
掠	扌京
伙	亻火
揣	扌耑
障	阝章
棺	木官
纤	纟千
淌	氵尚
匠	匚斤
询	讠旬
酯	酉旨
剃	弟刂
剁	朵刂
妄	亡女
恁	心任
牟	厶牛
娴	女闲
肽	月太
栈	木戋
厘	厂里
肘	月寸
曝	日暴
驳	马爻
澈	氵育
狱	犭讠
粟	覀米
搽	扌茶
飚	风火
脓	月农
屑	尸肖
皂	白七
涧	氵间
扳	扌反
绞	纟交
汞	二水
烛	火虫
绢	纟肙
毓	每㐬
埠	土阜
淇	氵其
佘	人示
刹	杀刂
遵	辶尊
卤	上乂
憨	心敢
羹	糕美
鳖	鱼敝
赣	章夂
唷	口育
斧	父斤
柒	木氵
弩	弓奴
筐	⺮匡
违	辶韦
菇	艹姑
撰	扌巽
棱	木夌
甭	不用
纺	纟方
剖	立刂
坨	土它
址	土止
瞿	隹目
舅	臼男
疤	疒巴
潇	氵萧
梢	木肖
哨	口肖
蚁	虫义
窃	穴切
卞	亠丶
秃	禾几
瞟	目票
拢	扌龙
碍	石日
寓	宀禺
蛤	虫合
辱	辰寸
凋	冫周
滤	氵虑
愤	忄贲
啪	口拍
励	厉力
镑	钅旁
虑	虍心
槐	木鬼
霆	雨廷
谂	讠念
妓	女支
眯	目米
诛	讠朱
侣	亻吕
崎	山奇
煜	火昱
蝇	虫黾
腥	月星
鸽	合鸟
蛆	虫且
砚	石见
锯	钅居
阙	门屰
诵	讠甬
泓	氵弘
噗	口业
缀	纟又
懿	壹心
焖	火闷
谛	讠帝
苹	艹平
嘟	口都
煌	火皇
缕	纟娄
弧	弓瓜
嗟	口差
缪	纟翏
巽	共巳
钵	钅本
捶	扌垂
椒	木叔
粽	米宗
拙	扌出
耸	耳从
钝	钅屯
陌	阝百
蛾	虫我
栖	木西
鸦	牙鸟
黏	黍占
艹	一丨
蹄	足帝
尬	尢介
茄	艹加
彰	章彡
韧	韦刃
酬	酉州
铀	钅由
脊	人月
翎	令羽
瀚	氵翰
楷	木皆
锥	钅隹
昼	尺旦
鞠	革勹
锰	钅孟
凿	业凵
茧	艹虫
敛	佥攵
歼	歹千
擒	扌禽
疮	疒仓
峪	山谷
俭	亻佥
淼	水水
胚	月丕
羡	羊次
鳞	鱼米
涓	氵肙
惧	忄具
撬	扌毛
釉	采由
纶	纟仑
昧	日未
锈	钅秀
睬	目采
绯	纟非
犁	牛利
喏	口若
驿	马又
漾	氵羊
莺	艹鸟
橘	木矛
纠	纟丩
竿	⺮干
郊	交阝
褐	衤日
糙	米造
桔	木吉
甸	勹田
殇	歹r
猿	犭袁
冢	冖豕
旷	日广
辊	车昆
魄	白鬼
纷	纟分
璧	玉辟
遁	辶盾
啼	口帝
笙	⺮生
烹	亨灬
喀	口客
韶	音召
娣	女弟
姝	女朱
嗣	口司
馀	饣余
腮	月思
铮	钅争
藉	艹耒
衷	亠𧘇
厦	厂夏
盔	灰皿
辖	车害
镖	钅票
鸥	区鸟
挟	扌夹
哗	口华
钗	钅叉
枉	木王
钞	钅少
迭	辶失
麓	鹿林
鲸	鱼京
喧	口宣
筝	⺮争
嗷	口敖
曜	日翟
诏	讠召
漠	氵莫
梭	木夋
垢	土后
恕	心如
轿	车乔
芮	艹内
栾	亦木
钳	钅甘
嚷	口襄
捎	扌肖
褪	衤退
肇	聿户
苞	艹包
宵	宀肖
镀	扌度
驼	马它
邬	乌阝
焱	火火
癖	疒辟
巍	山魏
毙	死比
庐	广户
叩	口卩
珏	王玉
爻	乂乂
嗔	口真
诈	讠乍
無	r灬
鸾	亦鸟
孽	艹子
饥	饣几
蕙	艹惠
絮	糸如
豁	害谷
褚	衤者
岱	山代
瀑	氵暴
括	扌舌
俯	亻府
摞	扌累
灏	氵景
骄	马乔
婶	女审
偿	亻尝
炯	火冂
硪	石我
岐	山支
堰	土匚
祯	礻贞
悼	忄卓
骤	马聚
匣	匚甲
渍	氵责
窟	穴屈
汶	氵文
荃	艹全
檀	木亶
焚	火林
谏	讠柬
韬	韦舀
浣	氵完
檐	木詹
藩	艹潘
钊	钅刂
唑	口坐
靶	革巴
榆	木俞
嚎	口豪
瓢	票瓜
擅	扌亶
鹭	鸟路
肢	月支
懵	忄艹
灼	火勺
坯	土丕
玺	尔玉
桢	木贞
玻	王皮
倘	亻尚
胥	乛月
仟	亻千
嵩	山高
摧	扌崔
谊	讠宜
仆	亻卜
尻	尸九
溴	灬臭
褒	亠𧘇
睛	目青
黯	黑音
鬓	宾镸
溃	氵贵
擎	手敬
怔	忄正
躁	足木
聋	龙耳
噜	口鲁
颁	分页
涝	氵劳
谎	讠荒
璋	王章
俐	亻利
钒	钅凡
圹	土广
谣	讠䍃
躬	身弓
沸	氵弗
疲	疒皮
蛊	虫皿
铂	钅白
脖	月孛
硒	石西
昱	日立
裡	衤里
嘀	口啇
葡	艹匍
匍	勹甫
毋	一丿
睹	目者
伶	亻令
裳	尚衣
垣	土亘
扼	扌厄
阉	门奄
遛	辶留
笃	⺮马
哆	口多
霁	雨齐
趾	足止
濑	氵赖
箍	⺮扌
瘫	疒难
痔	疒寺
洼	氵圭
烘	火共
钨	钅乌
瘀	疒於
隙	阝小
囡	口女
馍	饣莫
榨	木窄
辜	古辛
捋	扌爫
饵	饣耳
碾	石展
葆	廿保
缅	纟面
噤	口禁
蹿	足窜
麒	鹿其
癫	疒颠
蝎	虫日
戟	𠦝戈
鞘	革肖
椎	木隹
盅	中皿
襟	衤禁
胁	月办
拭	扌式
瘪	疒仑
绛	纟夅
铵	钅安
轶	车失
囚	口人
贻	贝台
昵	日尼
锚	钅苗
蓓	廿倍
宸	宀辰
铎	钅又
缚	纟甫
谐	讠皆
晔	日华
殴	区殳
钼	钅目
贮	贝宀
愧	忄鬼
涡	氵呙
樵	木焦
恬	忄舌
脐	月齐
稚	禾隹
岔	分山
嗄	口夏
丞	了一
翊	立羽
熵	火商
坞	土乌
玥	王月
硝	石肖
熄	火息
恺	忄岂
珉	王民
腊	月昔
怯	忄去
倭	亻委
跺	足朵
渭	氵胃
赎	贝卖
陇	阝龙
绸	纟周
邝	广阝
坂	土反
瘸	疒肉
饲	饣司
践	足戋
屿	山与
瞻	目詹
湝	氵皆
械	木戒
嘻	口喜
绫	纟夌
虱	乁丿
勉	免力
荔	艹力
寰	宀哀
绰	纟卓
痞	疒否
仄	厂人
肛	月工
竭	立日
踱	足度
啄	口豕
禧	礻喜
炕	火亢
泠	氵令
瘟	疒日
荼	艹余
荻	艹犭
缆	纟览
蔓	艹曼
漪	氵犭
匿	匚若
匝	匚巾
晤	日吾
疫	疒殳
厕	厂则
驮	马大
冼	冫先
窖	穴告
蔫	艹焉
骥	马冀
祀	礻巳
睦	目土
笺	⺮戋
暑	日者
咚	口冬
凳	登几
莞	艹完
枭	鸟木
倔	亻屈
鸠	九鸟
剔	易刂
樽	木尊
颊	夹页
礁	石焦
霓	雨兒
渚	氵者
婵	女单
讷	讠内
喆	吉吉
蒿	艹高
歆	音欠
噎	口壹
渺	氵目
涤	氵条
寮	宀尞
撼	扌感
炽	火只
町	田丁
抿	扌民
琨	王昆
茸	艹耳
烯	火希
噬	口⺮
搔	扌蚤
妒	女户
雏	刍隹
糠	米康
漱	氵束
嘲	口朝
薯	艹署
峥	山争
缇	纟是
萎	艹委
仂	亻力
憎	忄曾
粹	米卒
卟	口卜
歉	兼欠
胰	月夷
悍	忄旱
秧	禾央
蕉	艹焦
彝	彑廾
糯	米需
鲨	鱼沙
歧	止支
憾	忄感
谬	讠㐱
驹	马句
涕	氵弟
寐	宀爿
撵	扌辇
蒽	艹恩
荀	艹旬
绾	纟官
獒	犬敖
奢	大者
弛	弓也
夯	大力
溯	氵朔
璞	王业
狭	犭夹
拈	扌占
叛	半反
莽	艹廾
绷	纟朋
窘	穴君
內	冂入
绩	纟责
疣	疒尤
靡	麻非
桨	木丬
麼	麻幺
鳍	鱼老
勘	甚力
泗	氵四
拘	扌句
辙	车育
辇	车夫
抡	扌伦
汐	氵夕
锄	钅助
谅	讠京
剌	束刂
汲	氵及
墅	土野
簪	⺮日
暇	日卩
啤	口卑
舵	舟它
隅	阝禺
忻	忄斤
叭	口八
瀛	氵赢
琐	王v
苓	艹令
杵	木午
逍	辶肖
栅	木册
眩	目玄
棘	朿朿
硼	石朋
枢	木区
筠	⺮均
厥	厂屰
绥	纟妥
醛	酉荃
辫	辛纟
诞	讠延
姣	女交
羌	羊人
凛	冫禀
禀	亠示
珀	王白
娼	女昌
悄	忄肖
笠	⺮立
毗	田比
逞	辶呈
镉	钅一
癣	疒鲜
锂	钅里
糜	麻米
炙	夕火
咔	口卡
琰	王炎
圃	口甫
唠	口劳
凄	冫妻
姗	女册
沼	氵召
啧	口责
毯	毛炎
颓	秃页
琅	王良
颅	卢页
匙	是匕
梧	木吾
皋	白本
骊	马丽
唬	口虎
虏	虍力
萃	艹卒
螨	虫艹
疹	疒㐱
疝	疒山
稼	禾家
茫	艹氵
怂	心从
撅	扌厥
钴	钅古
晗	日含
孜	子攵
煨	火畏
柚	木由
弈	亦廾
毡	毛占
骇	马亥
蔽	艹敝
骞	宀马
鹃	肙鸟
恃	忄寺
综	纟宗
偕	亻皆
旻	日文
翡	羽非
馥	香复
凰	几皇
哌	口p
炊	火欠
诃	讠可
垄	龙土
樟	木章
莘	艹辛
骁	马尧
苛	艹可
磐	石般
瓮	公瓦
咂	口匝
挎	扌夸
珑	王龙
霏	雨非
犀	尸牛
罡	罒正
濮	氵亻
貂	豸召
滔	氵舀
熳	火曼
炬	火巨
攥	扌纂
柑	木甘
闺	门圭
囤	口屯
眷	丷目
舆	丿车
竺	⺮二
狸	犭里
洙	氵朱
吱	口支
邸	氐阝
谗	讠免
惩	心征
觞	角r
泾	氵乛
膳	月善
搀	扌免
轧	车乚
瘘	疒娄
嬉	女喜
椿	木春
髻	吉镸
秽	禾岁
矶	石几
沅	氵元
啖	口炎
锣	钅罗
吥	口不
戆	心章
躯	身区
滢	氵莹
濠	氵豪
锻	钅段
裆	衤当
旌	方r
暧	日爱
灞	氵霸
恪	丬各
畦	田圭
胯	月夸
弼	弓百
痹	疒丌
啜	口又
醚	酉迷
癸	癶天
禛	礻真
锺	钅重
摹	莫手
茉	艹末
酣	酉甘
腚	月定
蓟	艹鱼
吠	口犬
匾	匚扁
氰	r青
锛	钅奔
痂	疒加
妤	女予
羚	羊令
隽	乃隹
铠	钅岂
豚	月豕
璃	王离
墟	土虚
膘	月票
嫔	女宾
孓	了乀
抒	扌予
锕	钅阿
蹙	戚足
潞	氵路
蛹	虫甬
镭	钅雷
嘱	口属
峦	亦山
斟	甚斗
芋	艹于
骅	马华
湄	氵眉
鲤	鱼里
纂	算糸
煦	灬日
柿	木市
珺	王君
澎	氵彭
蜷	虫卷
酌	酉勺
濂	氵廉
煽	火扇
吮	口允
垛	土朵
蛟	虫交
渤	氵勃
顽	元页
骐	马其
芜	艹无
璟	王景
揩	扌皆
吁	口于
琉	王㐬
涔	氵岑
噌	口曾
糗	米臭
汕	氵山
缎	纟段
苘	艹冂
擂	扌雷
槌	木追
嗳	口爱
柠	木宁
徙	彳止
艰	又艮
拗	扌幼
崴	山威
蔷	艹啬
鸢	戈鸟
晦	日每
砰	石平
缨	纟婴
佣	亻用
铛	钅当
珈	王加
囿	口有
恍	忄光
褶	衤日
埔	土甫
啬	土回
嗡	口翁
粱	米氵
磬	石声
筷	⺮快
嗑	口去
漳	氵章
绚	纟旬
聆	耳令
泯	氵民
谕	讠俞
蔗	艹庶
昀	日匀
讼	讠公
峨	山我
檬	木蒙
侄	亻至
涟	氵连
沂	氵斤
侦	亻贞
廓	广郭
曙	日署
嗓	口桑
萦	艹糸
掳	扌虏
蔺	艹门
呱	口瓜
铨	钅全
鹊	昔鸟
沓	水日
踮	足店
辄	车耳
诡	讠危
犟	牛强
熹	喜灬
呷	口甲
郴	林阝
倡	亻昌
佯	亻羊
蕃	艹番
撂	扌田
沦	氵伦
罔	冂丷
吭	口亢
弑	杀式
厮	厂斯
橱	木厨
壤	土襄
壑	土睿
狙	犭且
咀	口且
赦	赤攵
灸	久火
烷	火完
橡	木象
蚌	虫丰
锝	钅日
菡	艹函
鄢	焉阝
咎	口处
懈	忄解
莓	艹每
剐	呙刂
孬	不好
讳	讠韦
箐	⺮青
骶	骨氐
烽	火夆
姊	女𠂔
庇	广比
垦	艮土
愉	忄俞
篱	⺮离
濡	氵需
沣	氵丰
飒	立风
钜	钅巨
蟒	虫莽
釜	父王
珞	王各
唰	口刷
烁	火乐
睑	目佥
咕	口古
懋	心木
坳	土幼
珅	王申
榭	木射
敞	尚攵
篷	⺮逢
膨	月彭
牡	牜土
簧	⺮黄
喈	口皆
焙	火立
膛	月堂
犊	牜卖
恢	忄灰
迩	辶尔
呤	口令
铐	钅考
棣	木隶
栎	木乐
牠	牜也
杞	木己
祢	礻尔
萤	艹忠
砣	石它
坷	土可
扈	户邑
慨	忄既
烩	火会
铉	钅玄
跋	足发
鳌	鱼敖
芊	艹千
掬	扌勹
鳃	鱼思
僚	亻尞
隘	阝益
惫	备心
驭	马又
篆	⺮彑
嘶	口斯
颦	卑频
桀	木夕
郢	呈阝
鄙	口阝
驯	马川
畸	田奇
陋	阝丙
汾	氵分
钡	钅贝
叨	口刀
隼	十隹
噩	王口
徵	彳山
阚	门敢
馊	饣叟
榻	木日
宕	宀石
烃	火乛
袂	衤夬
哺	口甫
渥	氵屋
瑰	王鬼
鼬	鼠由
朽	木丂
馈	饣贵
宦	宀臣
捺	扌奈
钥	钅月
伢	亻牙
祚	礻乍
耘	耒云
冕	日免
遐	辶卩
嘈	口曹
酰	酉先
舫	舟方
刎	勿刂
僻	亻辟
嚣	口口
屙	尸阿
鳄	鱼咢
佚	亻失
篓	⺮娄
伎	亻支
敕	束攵
诲	讠每
嗖	口叟
俪	亻丽
瑕	王卩
喳	口查
筵	⺮延
汛	氵卂
偎	亻畏
挚	手执
蹈	足舀
燎	火尞
捍	扌旱
暄	日宣
赃	贝庄
幔	巾曼
唛	口麦
蜕	虫兑
揖	扌口
讽	讠风
缁	纟巛
颌	合页
吆	口幺
幡	巾番
谟	讠莫
秩	禾失
俑	亻甬
沏	氵切
槛	木监
吡	口比
侩	亻会
蹇	宀足
掖	扌夜
衙	彳吾
岫	山由
箩	⺮罗
绽	纟定
龋	齿禹
靛	青定
颍	匕页
淦	氵金
鲲	鱼昆
箕	⺮其
秆	禾干
噔	口登
霭	雨讠
淬	氵卒
唧	口即
谌	讠甚
叱	口匕
础	石出
踵	足重
锢	钅固
桎	木至
阐	门单
扪	扌门
嫉	女疾
舸	舟可
摒	扌屏
悖	忄孛
偃	亻匚
蚝	虫毛
淞	氵松
讥	讠几
怠	台心
晰	日析
嗝	口一
捱	扌厓
姥	女老
涎	氵延
婿	女胥
迸	辶并
栀	木p
擀	扌𠦝
沱	氵它
绅	纟申
唸	口念
喱	口厘
裱	衤表
氦	气亥
饺	饣交
袅	鸟衣
淀	氵定
钺	钅戊
扉	户非
漕	氵曹
荪	艹孙
葭	艹卩
谥	讠益
稽	禾尤
幂	冖巾
磺	石黄
洵	氵旬
戮	㐱戈
朦	月蒙
殖	歹直
孵	卵孚
吋	口寸
屹	山乞
碴	石查
谍	讠世
矾	石凡
岙	夭山
羟	羊乛
妨	女方
掴	扌国
恳	艮心
羿	廾羽
抻	扌申
盹	目屯
孢	乛孑包
濯	氵翟
舷	舟玄
腑	月府
怖	忄布
锑	钅弟
虔	虍文
萘	艹奈
咿	口伊
荟	艹会
矜	矛今
尕	乃小
萼	艹咢
鬃	宗镸
逵	辶土
潼	氵童
喙	口彑
煊	火宣
撸	扌鲁
绡	纟肖
疱	疒包
郦	丽阝
筏	钅伐
杳	木日
饷	饣向
啐	口卒
诫	讠戒
镐	钅高
舶	舟白
诣	讠旨
楣	木眉
汰	氵太
荚	艹夹
褂	衤卦
偈	亻日
啡	口非
篡	⺮厶
讹	讠化
颚	咢页
惭	忄斩
殆	歹台
痢	疒利
谒	讠日
珩	王行
焯	火卓
穹	穴弓
椀	木宛
嫡	女亠
赘	贝敖
蟾	虫詹
诬	讠巫
氓	亡民
眶	目匡
暸	日尞
楔	木契
雉	矢隹
铆	钅卯
吝	文口
祗	礻氐
枷	木加
痧	疒沙
蜗	虫呙
帷	巾隹
咨	口次
铣	钅先
婢	女卑
嘬	口最
髯	冉镸
琏	王连
螯	虫敖
璜	王黄
榴	木留
赊	贝余
忱	忄冘
娑	女沙
唾	口垂
梃	木廷
圳	土川
芥	艹介
俟	亻矣
伺	亻司
骡	马累
膈	月一
剜	宛刂
巅	山颠
痨	疒劳
睫	目疌
榛	木秦
铿	钅坚
阪	阝反
蔬	艹疏
澶	氵亠
宓	宀必
啷	口郎
晁	日兆
呲	口此
瓤	襄瓜
峩	山我
哏	口艮
蛰	虫执
跷	足尧
溺	氵弱
皎	白交
戾	户犬
仝	人工
陨	阝员
嘣	口崩
翀	羽中
昙	日云
苒	艹冉
牲	牜生
塾	土孰
壕	土豪
颉	吉页
鳝	鱼善
胫	月乛
鸳	鸟夕
耙	耒巴
蘑	艹磨
琀	王含
翌	立羽
嗪	口秦
耨	耒辱
缔	纟帝
挀	扌𠂢
荧	艹火
砺	石厉
泌	氵必
颞	聂页
羁	罒革
圩	土于
竣	立夋
衾	今衣
槎	木差
骸	骨亥
挝	扌过
邈	辶貌
耽	耳冘
葳	艹威
夙	几歹
恣	心次
辐	车一
谯	讠焦
椴	木段
赈	贝辰
砾	石乐
蛛	虫朱
冽	冫列
拄	扌主
蘼	艹靡
熠	火白
焗	火局
忿	分心
踝	足果
俘	亻孚
棹	木卓
睐	目来
掣	手制
惶	忄皇
祆	礻天
臊	月木
琬	王宛
锉	钅坐
鳗	鱼曼
蚜	虫牙
钿	钅田
芍	艹勺
铰	钅交
岷	山民
咣	口光
塬	土原
瓒	王赞
遏	辶日
钚	钅不
嵘	山荣
蔑	艹戍
蝗	虫皇
洀	氵舟
耆	老日
贿	贝有
漩	氵旋
跛	足皮
绉	纟刍
慵	忄庸
羯	羊日
咻	口休
鹫	鸟就
缮	纟善
昇	日升
娉	女由
祐	礻右
颢	景页
舛	夕丨
琮	王宗
蘅	艹衡
锴	钅皆
肴	乂有
殃	歹央
銮	亦金
屉	尸世
郅	至阝
猷	酋犬
狩	犭守
耦	耒禺
殉	歹旬
蛀	虫主
陛	阝土
谧	讠必
玟	王文
锆	钅告
锗	钅者
祷	礻寿
锟	钅昆
浚	氵夋
椽	木彑
恙	羊心
谤	讠旁
孺	孑需
漓	氵离
珮	王几
镛	钅庸
奠	酋大
谙	讠音
痿	疒委
浏	氵刘
姘	女并
剿	巢刂
啮	口齿
蝠	虫一
愕	忄咢
煸	火扁
倌	亻官
哽	口更
壅	雍土
惰	忄左
斛	角斗
骋	马由
郜	告阝
噙	口禽
浠	氵希
囔	口囊
谰	讠阑
慑	忄聂
黍	禾氺
翩	扁羽
盂	于皿
跤	足交
胧	月龙
嗽	口束
酪	酉各
媳	女息
寥	宀㐱
怅	忄长
龛	合龙
桉	木安
哮	口孝
腱	月建
渎	氵卖
髂	骨客
膀	月旁
谚	讠彦
嗤	口蚩
蚩	山虫
俸	亻奉
闾	门吕
瑙	王巛
殁	歹殳
贲	贝十
怵	忄术
箔	⺮泊
芡	艹欠
氽	人水
迄	辶乞
粲	米歺
狡	犭交
峭	山肖
硌	石各
義	羊我
桅	木危
牒	片世
蒯	艹刂
弁	厶廾
镬	钅艹
辕	车袁
藜	艹黎
溏	氵唐
箴	⺮咸
钕	钅女
瑄	王宣
槿	木堇
勫	番力
阖	门去
瓯	区瓦
宥	宀有
讵	讠巨
吒	口乇
桡	木尧
拇	扌母
帜	巾只
蜃	辰虫
迴	辶回
牺	牛西
酗	酉凶
亟	了一
诠	讠全
鱿	鱼尤
寞	宀莫
臆	月意
峙	山寺
藐	艹貌
幌	巾晃
腋	月夜
妲	女旦
蜇	虫折
踞	足居
埂	土更
锃	钅呈
譬	言辟
谀	讠臼
喋	口世
缈	纟目
缥	纟票
矗	直直
侈	亻多
戛	百戈
阱	阝井
惕	忄易
璨	王米
氛	气分
愀	忄秋
佗	亻它
恹	忄厌
睢	目隹
垃	土立
疙	疒乞
栩	木羽
杈	木叉
椤	木罗
揆	扌癸
徊	彳回
盎	央皿
琶	巴王
缉	纟口
橇	木手
琇	王秀
侮	亻每
汴	氵卞
焘	灬寿
誊	丷言
砧	石占
侗	亻同
匮	匚贵
腭	月咢
铡	钅则
忖	忄寸
嶂	山章
琥	王虎
翱	皋羽
铊	钅它
腩	月南
膻	月亶
湍	氵耑
惺	忄星
愠	忄日
妊	女壬
驷	马四
钏	钅川
莅	艹位
鲫	鱼即
虬	虫乚
膺	广月
诧	讠宅
苕	艹召
乒	丘丿
阈	门或
辍	车又
皙	日析
蹴	足就
婊	女表
疵	疒此
褉	衤契
嗫	口聂
啉	口林
蔼	艹谒
攘	扌襄
螟	虫冥
仞	亻刃
蹋	足日
楹	木盈
墒	土商
鹆	谷鸟
阕	门癸
熨	火尉
蓑	艹衰
谪	讠商
噘	这厥
棰	木垂
锹	钅秋
缃	纟相
莆	艹甫
跖	足石
缙	纟晋
遽	辶虍
镯	钅蜀
泅	氵囚
迂	辶于
镂	钅娄
蜒	虫延
氡	气冬
涣	氵奂
绎	纟又
渲	氵宣
滟	氵艳
痈	疒用
谴	讠遣
粕	米白
悯	忄闵
粑	米巴
沤	氵区
拯	扌丞
苄	艹卞
钎	钅千
觑	虚见
窒	穴至
绦	纟条
兢	克克
箸	⺮者
傣	亻泰
诘	讠吉
雒	各隹
镰	钅廉
矽	石夕
蕨	艹厥
蓼	艹翏
疟	疒匚
锶	钅思
璎	王婴
骰	骨殳
沮	氵且
蔻	艹寇
崧	山松
璀	王崔
啶	口定
镗	钅堂
伫	亻宀
跚	足册
氖	气乃
娲	女足
绀	纟甘
佃	亻田
垚	土土
癞	疒赖
泷	氵龙
庾	广臼
髁	骨果
泸	冫卢
晌	日向
馁	饣妥
祉	礻止
珪	王圭
茴	艹回
钽	钅旦
稷	禾田
馕	饣囊
荜	艹毕
钯	钅巴
湜	氵是
垅	土龙
泮	氵半
濒	氵频
隧	阝遂
嫦	女常
霈	雨沛
纣	纟寸
褋	礻世
祜	礻古
橹	木鲁
蟀	虫率
邰	台阝
腴	月臼
忏	忄千
腓	月非
赭	赤者
睨	目兒
嚯	这霍
嵇	禾尤
髋	骨宽
佸	亻舌
彗	彐丰
皑	白岂
铌	钅尼
轲	车可
倏	亻丨
劭	召力
韫	韦日
讫	讠乞
嘁	口戚
埭	土隶
枳	木只
芠	艹文
铋	钅必
浔	氵寻
唦	口沙
螭	虫离
娆	女尧
呶	口奴
铖	钅成
锷	钅咢
帏	巾韦
碇	石定
昴	日卯
肱	月厷
醌	酉昆
诒	讠台
畈	田反
哞	口牟
恽	忄军
撷	扌颉
妫	女为
莜	艹攸
桁	木行
魇	厌鬼
濞	氵鼻
蔸	艹兜
炀	火𠄎
佷	亻艮
菩	艹口
揸	扌查
迳	辶乛
衿	衤今
拻	扌灰
葶	艹亭
俨	亻严
芩	艹今
磋	石差
堑	土斩
猩	犭星
苡	艹以
蹩	足敝
胄	由月
殒	歹员
炔	火夬
殓	歹佥
炝	火仓
铟	钅因
郗	希阝
垭	土亚
掸	扌单
凫	鸟几
陂	阝皮
骈	马并
斫	石斤
晞	日希
窿	穴隆
邕	巛邑
垠	土艮
遒	辶酋
镱	钅意
稗	禾卑
轸	车㐱
颀	斤页
碌	石录
潍	氵维
洱	氵耳
鞅	革央
稔	禾念
莃	艹希
诽	讠非
徇	彳旬
忤	忄午
噫	口意
裾	衤居
骠	马票
偌	亻若
酵	酉孝
嘹	口尞
锵	钅将
诳	讠狂
涸	氵固
淖	氵卓
坍	土丹
萜	艹帖
澹	氵詹
恸	忄动
斓	文阑
瘢	疒般
袱	衤伏
褥	衤辱
蝙	虫扁
缤	纟宾
殡	歹宾
雹	雨包
槟	木宾
榔	木郎
菠	艹波
徘	彳非
蹒	足井
胱	月光
彷	彳方
徨	彳皇
螃	虫旁
咆	口包
嚏	口十
湃	氵拜
抨	扌平
饪	饣壬
枇	木比
杷	木巴
琵	比王
媲	女囱
霹	雨辟
雳	雨历
貔	豸囱
貅	豸休
砒	石比
袒	衤旦
剽	票刂
瘠	疒脊
乓	丘乀
匐	勹一
萄	艹匋
蚂	虫马
谩	讠曼
馒	饣曼
牦	牛毛
笈	⺮及
惘	忄罔
腼	月面
腆	月典
嬷	女麼
蓦	莫马
蛎	虫厉
砝	石去
娩	女免
吩	口分
咐	口付
纫	纟刃
狒	犭弗
痱	疒非
驸	马付
涪	氵戾
瞰	目敢
耷	大耳
讪	讠山
挞	扌达
诋	讠氐
簸	⺮其
惦	忄店
痫	疒闲
玷	王占
碉	石周
咛	口宁
忐	上心
忑	下心
婪	女林
痪	疒n
劾	亥力
螳	虫堂
螂	虫郎
搪	扌唐
饕	食号
餮	食歹
籁	⺮赖
衅	血半
鸵	鸟它
椭	木阝
诿	讠委
讧	讠工
疚	疒久
泞	氵宁
鳅	鱼秋
懦	忄需
毂	土殳
邋	辶巛
遢	辶日
圾	土及
徕	彳来
狈	犭贝
鸨	匕鸟
衲	衤内
崂	山劳
笆	⺮巴
罹	罒惟
缭	纟尞
亵	亠𧘇
佼	亻交
侏	亻朱
侥	亻尧
傀	亻鬼
儡	亻田
刽	会刂
呻	口申
咄	口出
咙	口龙
咫	尺只
唏	口希
嗬	口荷
噱	口虍
噼	口辟
嚓	口察
奘	大爿
妩	女无
娓	女尾
娠	女辰
婀	女阿
婺	女矛
尴	尢监
岖	山区
崛	山屈
崭	山斩
嵋	山眉
帚	彐巾
帼	巾国
徉	彳羊
徜	彳尚
忡	忄中
恿	甬心
悚	忄束
悴	忄卒
悸	忄季
惆	忄周
惋	忄宛
惚	忄忽
惬	忄匚
惮	忄单
愫	忄素
慷	忄康
憔	忄焦
憧	忄童
憩	心舌
憬	忄景
懊	忄奥
抉	扌夬
拮	扌吉
挛	亦手
搐	扌畜
攫	扌又
斡	𠦝人
旎	方𠂉
旖	方𠂉
旮	九日
旯	日九
枸	木句
桧	木会
楂	木查
榈	木闾
榷	木隺
氤	气因
氲	气日
汹	氵凶
沌	氵屯
浒	氵许
淄	讠巛
淆	氵肴
湮	氵西
溉	氵既
滁	氵除
滓	氵宰
漉	氵鹿
漯	氵累
潢	氵黄
潺	氵尸
炅	日火
烬	火尽
犒	牛高
犷	犭广
狞	犭宁
狰	犭争
猕	犭弥
猖	犭昌
猝	犭卒
猥	犭畏
猬	犭胃
猾	犭骨
獗	犭厥
瑚	王胡
甥	生男
疡	疒𠄎
疸	疒旦
痉	疒乛
痊	疒全
痤	疒坐
瘙	疒蚤
瘩	疒艹
瘴	疒章
癜	疒殿
皈	白反
眈	目冘
睾	丿幸
瞌	目去
瞠	目堂
瞩	目属
碁	其石
祟	出示
秸	禾吉
稣	鱼禾
窈	穴幼
窕	穴兆
篝	⺮冉
粳	米更
紊	文系
纭	纟云
缄	纟咸
缜	纟真
罂	缶贝
肪	月方
肮	月亢
胭	月因
胳	月各
脍	月会
脯	月甫
臃	月雍
芪	艹氏
茁	艹出
荞	艹乔
荨	艹寻
莠	艹秀
菏	艹河
葫	艹胡
蚓	虫引
蚣	虫公
蚪	虫斗
蚯	虫丘
蛐	虫曲
蛔	虫回
蜈	虫吴
蜍	虫余
蜓	虫廷
蜘	虫知
蜥	虫析
蜴	虫易
蜻	虫青
蜿	虫宛
蝈	虫国
蝌	虫科
蝴	虫胡
蟆	虫莫
蟋	虫悉
蟑	虫章
蠕	虫需
衢	彳瞿
衩	衤叉
袤	亠𧘇
觊	岂见
觎	俞见
讴	讠区
讶	讠牙
诅	讠且
诙	讠灰
诟	讠后
诩	讠羽
谑	讠虐
豌	豆宛
赁	贝任
赂	贝各
赝	雁贝
赡	贝詹
跄	足仓
跆	足台
跻	足齐
踉	足良
踊	足甬
踌	足寿
蹂	足柔
蹊	足奚
蹶	足厥
躇	足著
躏	足蔺
轼	车式
辗	车展
迢	辶召
逅	辶后
遨	辶敖
遴	辶米
邂	辶解
邃	辶穴
邯	甘阝
郸	单阝
酝	酉云
锏	钅间
锲	钅契
镳	钅鹿
阂	门亥
隍	阝皇
霾	雨豸
颧	艹页
飓	风具
饨	饣屯
馄	饣昆
馏	饣留
骷	骨古
骼	骨各
髅	骨娄
髦	毛镸
鬟	𧘇镸
鸯	央鸟
鹉	武鸟
鹌	奄鸟
鹑	享鸟
鹦	婴鸟
麾	麻毛
黝	黑幼
鼾	鼻干
龈	齿艮
龊	齿足
龌	齿屋
辔	口纟
矬	矢坐
埙	土员
诤	讠争
纾	纟予
蠹	十虫
铑	钅老
墉	土庸
阡	阝千
厩	厂既
啾	口秋
祼	礻果
柘	木石
藓	艹鲜
葩	艹白
虢	爫虍
氩	气亚
傚	亻效
琍	王利
珥	王耳
梆	木邦
鲛	鱼交
姹	女宅
羧	羊夋
煅	火段
俚	亻里
铳	钅充
璘	王米
狎	犭甲
洮	氵兆
哔	口毕
泱	氵央
哂	口西
獾	犭艹
哐	口匡
劵	丷力
皤	白番
颏	亥页
骧	马襄
眦	目此
枋	木方
嘭	口彭
椁	木享
豺	豸才
擢	扌翟
舐	舌氏
堀	土屈
圮	土己
洹	氵亘
苻	艹付
圪	土乞
欹	奇欠
篙	⺮高
谝	讠扁
舂	𡗗臼
诌	讠刍
诰	讠告
纨	纟丸
汆	入水
唵	口奄
菂	艹的
祓	礻发
麝	鹿射
缰	纟一
谔	讠咢
樯	木啬
芃	艹凡
菅	艹管
鲷	鱼周
滂	氵旁
彘	彑匕
玑	王几
屐	尸彳
霰	雨散
铢	钅朱
蟠	虫番
邛	工阝
玳	王代
镌	钅隽
揶	扌耶
椐	木居
蚬	虫见
枙	木厄
涞	冫来
豉	豆支
恻	忄则
峤	山乔
栊	木龙
珐	王去
鹜	鸟矛
潴	氵猪
枟	木云
酊	酉丁
塚	土冢
杩	木马
摺	扌白
叵	匚口
菘	艹松
楸	木秋
牝	牛匕
渌	氵录
笏	⺮勿
铒	钅耳
蚧	虫介
腈	月青
桠	木亚
绺	纟咎
酽	酉严
佞	亻一
浼	氵免
殚	歹单
炆	火文
籼	米山
绻	纟卷
瑀	王禹
妣	女比
掇	扌又
铄	钅乐
铧	钅华
铕	钅有
骀	马台
薏	艹意
搡	扌桑
婠	女官
逯	辶录
蹑	足聂
砜	石风
昉	日方
罄	缶声
瑨	王晋
溱	氵秦
嫒	女爱
茱	艹朱
鲟	鱼寻
琚	王居
怆	忄仓
哧	口赤
洇	氵因
姒	女以
淅	氵析
噯	口爱
钤	钅今
哝	口农
逑	辶求
瞑	目冥
畑	火田
燧	火丷
镲	钅察
苫	艹占
狷	犭肙
鹞	䍃鸟
崮	山固
鲈	鱼卢
鼢	鼠分
茆	艹卯
潦	氵尞
嶷	山疑
仵	亻午
鲠	鱼更
趸	万足
砭	石乏
铍	钅皮
岘	山见
麸	麦夫
骛	马矛
黜	黑出
咭	口吉
洌	氵列
鹂	丽鸟
呖	口历
鸩	冘鸟
唳	口戾
楫	木口
嬛	女罒
峒	山同
掼	扌贯
焓	火含
嗥	口皋
猗	犭奇
阏	门方
铱	钅衣
麂	鹿几
楮	木者
觇	占见
湟	氵皇
呋	口夫
赳	走丩
幄	巾屋
醮	酉焦
醴	酉曲
诓	讠匡
悌	忄弟
疽	疒且
嫫	女莫
瑷	王爱
骓	马隹
潧	氵曾
轭	车厄
幛	巾章
擤	扌鼻
铈	钅市
蹰	足厨
墀	土犀
珲	王军
獭	犭赖
镧	钅阑
檄	木白
鲧	鱼系
愍	心民
隗	阝鬼
庖	广包
惇	忄享
讣	讠卜
珣	王旬
玎	王丁
邳	丕阝
砥	石氏
枰	木平
缢	纟益
鲑	鱼珪
洄	氵回
郯	炎阝
泫	氵玄
绠	纟更
岬	山甲
嫱	女啬
瑁	王冒
恫	忄同
恂	忄旬
哙	口会
榘	木矢
谄	讠n
硷	石佥
岿	山归
囝	口子
倜	亻周
饬	饣𠂉
傜	亻䍃
酞	酉太
呯	口平
槊	木朔
鸬	卢鸟
媞	女是
抟	扌专
汜	氵巳
涘	氵矣
焐	火吾
膦	月米
獠	犭尞
糍	米兹
驺	马刍
洧	氵有
淙	氵宗
鎏	金流
饴	饣台
饯	饣戋
滃	氵翁
醪	酉㐱
陟	阝步
佶	亻吉
篦	⺮比
犇	牛牛
嚅	口需
熘	火留
獐	犭章
氪	气克
咲	口关
镒	钅益
涐	氵我
忔	忄乞
焜	火昆
篾	⺮戍
眇	目少
苧	艹宁
闼	门达
簋	⺮皿
悗	忄免
疖	疒卩
俦	亻寿
媪	女日
玠	王介
缦	纟曼
臌	月鼓
牯	牛古
苋	艹见
骟	马扇
瓠	夸瓜
扦	扌千
毽	毛建
炟	火旦
祎	礻韦
虓	九虎
昶	永日
蚱	虫乍
蜢	虫孟
璠	王番
洨	氵交